###    ###
###    ###
##      ##
## **** ##
##      ##
##      ##
##      ##
##      ##
##      ##
##  .   ##
##      ##
###     ##
###     ##
###     ##
###     ##
####    ##
####  . ##
####    ##
####    ##
####    ##
####   ###
####   ###
###    ###
###   ####
###   ####
### . ####
###    ###
###    ###
####   ###
####   ###
####    ##
####    ##
####  . ##
####    ##
####    ##
####    ##
####   ###
####   ###
###    ###
###   ####
###   ####
### . ####
###    ###
###    ###
####   ###
####   ###
####    ##
####    ##
####  . ##
####    ##
#### *  ##
####    ##
####   ###
####   ###
###    ###
###   ####
###   ####
###*. ####
###    ###
###    ###
####   ###
####   ###
####    ##
####*   ##
####  . ##
####    ##
####   *##
####    ##
####   ###
####   ###
###  * ###
###   ####
###   ####
### . ####
###    ###
###    ###
####   ###
####   ###
####*   ##
####    ##
####  . ##
####    ##
####    ##
####    ##
####   ###
####  *###
###    ###
###   ####
###   ####
### . ####
###****###
###****###
####***###
####   ###
####    ##
####    ##
####  . ##
####    ##
####    ##
####    ##
####   ###
####   ###
###    ###
###   ####
###   ####